111111111111111111111111111111111111111111111
100000000000000000000000000000000000000000001
1000000P0000000000000111000000000000000000001
1000000000111100000001E1000000000000000000001
10000000000CC10000000101000000000000000000001
100000000011110000000000011111111110000000001
10000000000000000000000000CCCCCCCC10000000001
1000000000000000000000000101111CCC10000000001
100000001111100000000000010000CCCC10000000001
100000000000100000000000011111111110000000001
100000000001011000000000000000000000000000001
100000000000000000000000000000000000000000001
100000000000000000000000000000000000000000001
100000000000000000000000000000000000000000001
100000000000000000000000000000000000000000001
111111111111111111111111111111111111111111111