111111111111111111111111111111111111111111111
100000000000000000000000000000000000000000001
1000000P0000000000000000000000000000000000001
100000000000000000000000000000000000000000001
1000000000E0000000000000000000000000000000001
100000000000000000000000011111111110000000001
100000000000000000000000000000000010000000001
100000000000000000000000010111100010000000001
100000001111100000000000010000000010000000001
100000000000100000000000011111111110000000001
100000000001011000000000000000000000000000001
100000000000000000000000000000000000000000001
100000000000000000000000000000000000000000001
1000000000000000000000000000000C0000000000001
100000000000000000000000000000000000000000001
111111111111111111111111111111111111111111111